NO ./assets/WALL.xpm
SO ./assets/WALL.xpm
WE ./assets/WALL.xpm
EA ./assets/wall_torch_01.xpm

F 220,100,0
C 225,30,0

1111111
1D000D1
1000001
100N001
1000001
1000001
1111111
